  #####
###...#
#X....#
###..X#
#X##..#
#.#.X.##
#..X..X#
#...X..#
########

2,2

3,2
4,3
4,4
1,6
3,6
4,6
5,6
