     ####
     #..#####
    ##......#
#####...##..#
#.XX#.#.##.##
#........#.##
##..#.#....##
#####...##.##
    ######..#
    #X......#
    #########

6,2

6,5
10,5
10,7
